/*

 MAP.B3.C

 Map Source File.

 Info:
   Section       : 
   Bank          : 0
   Map size      : 40 x 18
   Tile set      : tiles.gbr
   Plane count   : 1 plane (8 bits)
   Plane order   : Tiles are continues
   Tile offset   : 0
   Split data    : No

 This file was generated by GBMB v1.8

*/

#define mapWidth 40
#define mapHeight 18
#define mapBank 0

unsigned char map[] =
{
  0x01,0x01,0x01,0x01,0x01,0x01,0x01,0x01,0x01,0x01,
  0x01,0x01,0x01,0x01,0x01,0x01,0x01,0x01,0x01,0x01,
  0x01,0x01,0x02,0x02,0x02,0x02,0x02,0x02,0x02,0x02,
  0x02,0x02,0x02,0x02,0x02,0x02,0x02,0x02,0x02,0x02,
  0x01,0x03,0x03,0x00,0x00,0x00,0x00,0x03,0x00,0x00,
  0x00,0x03,0x00,0x00,0x03,0x03,0x00,0x03,0x01,0x01,
  0x01,0x01,0x01,0x03,0x03,0x00,0x00,0x00,0x03,0x03,
  0x03,0x03,0x03,0x00,0x00,0x00,0x03,0x03,0x01,0x02,
  0x01,0x00,0x00,0x00,0x03,0x00,0x00,0x00,0x00,0x00,
  0x00,0x00,0x00,0x00,0x00,0x00,0x03,0x03,0x01,0x01,
  0x01,0x01,0x02,0x03,0x00,0x00,0x03,0x00,0x00,0x00,
  0x00,0x00,0x00,0x00,0x03,0x00,0x00,0x03,0x03,0x02,
  0x01,0x03,0x03,0x00,0x00,0x00,0x00,0x03,0x03,0x03,
  0x03,0x03,0x03,0x03,0x03,0x00,0x00,0x03,0x01,0x01,
  0x01,0x01,0x01,0x03,0x00,0x04,0x02,0x02,0x02,0x02,
  0x02,0x02,0x02,0x02,0x02,0x03,0x03,0x00,0x03,0x02,
  0x01,0x01,0x01,0x01,0x01,0x01,0x01,0x01,0x01,0x01,
  0x01,0x01,0x01,0x01,0x01,0x00,0x00,0x03,0x01,0x01,
  0x01,0x01,0x01,0x03,0x00,0x03,0x01,0x02,0x02,0x02,
  0x02,0x02,0x02,0x02,0x02,0x03,0x03,0x00,0x03,0x02,
  0x01,0x01,0x01,0x01,0x01,0x01,0x01,0x01,0x01,0x01,
  0x01,0x01,0x01,0x01,0x01,0x00,0x00,0x03,0x01,0x01,
  0x01,0x01,0x01,0x03,0x00,0x03,0x01,0x02,0x02,0x02,
  0x02,0x02,0x02,0x02,0x02,0x03,0x03,0x00,0x00,0x02,
  0x01,0x02,0x02,0x02,0x03,0x03,0x03,0x03,0x03,0x03,
  0x03,0x03,0x03,0x00,0x00,0x00,0x00,0x03,0x01,0x01,
  0x01,0x01,0x02,0x03,0x00,0x03,0x01,0x02,0x02,0x02,
  0x02,0x02,0x02,0x02,0x02,0x03,0x03,0x00,0x03,0x02,
  0x01,0x02,0x02,0x02,0x03,0x03,0x00,0x00,0x04,0x00,
  0x00,0x00,0x00,0x03,0x04,0x03,0x03,0x03,0x01,0x01,
  0x01,0x01,0x01,0x03,0x00,0x03,0x03,0x01,0x01,0x01,
  0x01,0x01,0x01,0x01,0x02,0x01,0x00,0x00,0x01,0x02,
  0x01,0x02,0x02,0x02,0x00,0x04,0x00,0x00,0x00,0x00,
  0x03,0x03,0x03,0x03,0x03,0x03,0x03,0x03,0x01,0x01,
  0x01,0x01,0x02,0x00,0x00,0x00,0x03,0x00,0x00,0x03,
  0x03,0x03,0x03,0x01,0x02,0x02,0x00,0x03,0x02,0x02,
  0x01,0x01,0x01,0x01,0x03,0x00,0x00,0x00,0x00,0x01,
  0x01,0x01,0x01,0x01,0x01,0x01,0x01,0x01,0x01,0x01,
  0x01,0x01,0x01,0x03,0x03,0x00,0x00,0x00,0x00,0x00,
  0x03,0x04,0x03,0x01,0x02,0x02,0x00,0x00,0x02,0x02,
  0x01,0x01,0x01,0x01,0x03,0x00,0x00,0x00,0x03,0x01,
  0x01,0x01,0x01,0x01,0x01,0x01,0x01,0x01,0x01,0x01,
  0x01,0x01,0x02,0x03,0x03,0x03,0x03,0x03,0x00,0x00,
  0x00,0x00,0x03,0x01,0x02,0x02,0x03,0x00,0x02,0x02,
  0x01,0x01,0x01,0x01,0x03,0x00,0x00,0x00,0x00,0x01,
  0x01,0x01,0x01,0x01,0x01,0x01,0x01,0x01,0x01,0x01,
  0x01,0x01,0x01,0x02,0x01,0x02,0x01,0x01,0x01,0x01,
  0x03,0x00,0x03,0x01,0x02,0x02,0x03,0x00,0x00,0x02,
  0x01,0x01,0x01,0x01,0x00,0x00,0x00,0x00,0x00,0x01,
  0x01,0x01,0x01,0x01,0x01,0x01,0x01,0x01,0x01,0x01,
  0x01,0x01,0x01,0x01,0x01,0x01,0x01,0x01,0x01,0x01,
  0x03,0x00,0x03,0x01,0x02,0x02,0x03,0x00,0x03,0x02,
  0x01,0x02,0x02,0x02,0x00,0x00,0x00,0x00,0x03,0x03,
  0x02,0x02,0x02,0x02,0x02,0x02,0x02,0x02,0x02,0x02,
  0x01,0x01,0x01,0x01,0x01,0x01,0x01,0x01,0x01,0x01,
  0x03,0x00,0x03,0x01,0x02,0x02,0x03,0x00,0x00,0x02,
  0x01,0x02,0x02,0x02,0x00,0x00,0x00,0x00,0x00,0x00,
  0x03,0x03,0x03,0x03,0x00,0x03,0x03,0x03,0x03,0x03,
  0x02,0x02,0x02,0x02,0x02,0x02,0x02,0x02,0x02,0x01,
  0x03,0x00,0x04,0x01,0x02,0x02,0x02,0x00,0x00,0x02,
  0x01,0x02,0x02,0x02,0x03,0x04,0x03,0x00,0x00,0x00,
  0x00,0x00,0x00,0x00,0x00,0x00,0x00,0x00,0x00,0x00,
  0x03,0x03,0x03,0x03,0x03,0x00,0x03,0x03,0x00,0x03,
  0x00,0x00,0x03,0x01,0x02,0x02,0x02,0x03,0x00,0x02,
  0x01,0x02,0x02,0x02,0x03,0x03,0x03,0x03,0x03,0x03,
  0x03,0x03,0x03,0x03,0x03,0x03,0x03,0x03,0x03,0x00,
  0x00,0x00,0x00,0x00,0x00,0x00,0x00,0x00,0x00,0x00,
  0x00,0x03,0x03,0x01,0x02,0x02,0x02,0x03,0x03,0x02,
  0x01,0x01,0x01,0x01,0x01,0x01,0x01,0x01,0x01,0x01,
  0x01,0x01,0x01,0x01,0x01,0x01,0x01,0x01,0x01,0x01,
  0x01,0x01,0x01,0x01,0x01,0x01,0x01,0x01,0x01,0x01,
  0x01,0x01,0x01,0x01,0x01,0x01,0x01,0x01,0x01,0x01
};

/* End of MAP.B3.C */
