/*

 MAP.B3.C

 Map Source File.

 Info:
   Section       : 
   Bank          : 0
   Map size      : 40 x 20
   Tile set      : tiles.gbr
   Plane count   : 1 plane (8 bits)
   Plane order   : Tiles are continues
   Tile offset   : 0
   Split data    : No

 This file was generated by GBMB v1.8

*/

#define mapWidth 40
#define mapHeight 20
#define mapBank 0

unsigned char map[] =
{
  0x01,0x01,0x01,0x01,0x01,0x01,0x01,0x01,0x01,0x01,
  0x01,0x01,0x01,0x01,0x01,0x01,0x01,0x01,0x01,0x01,
  0x01,0x01,0x02,0x02,0x02,0x02,0x02,0x02,0x02,0x01,
  0x01,0x01,0x02,0x02,0x02,0x02,0x02,0x02,0x02,0x02,
  0x01,0x0B,0x07,0x07,0x07,0x07,0x07,0x07,0x07,0x07,
  0x07,0x07,0x07,0x07,0x07,0x07,0x07,0x0A,0x01,0x01,
  0x01,0x01,0x01,0x06,0x00,0x00,0x00,0x00,0x03,0x07,
  0x07,0x07,0x00,0xFE,0x00,0x00,0x03,0x08,0x01,0x02,
  0x01,0x06,0x00,0x00,0x03,0x00,0x00,0x00,0x00,0x00,
  0x00,0x00,0x00,0x00,0x00,0x00,0x03,0x08,0x01,0x01,
  0x01,0x01,0x01,0x06,0x00,0x00,0x03,0x00,0x00,0x00,
  0x00,0x00,0x00,0x00,0x03,0x00,0x00,0x00,0x07,0x02,
  0x01,0x06,0x00,0x00,0x00,0x00,0x00,0x00,0x00,0x00,
  0x00,0x00,0x00,0x00,0x00,0x00,0x00,0x08,0x01,0x01,
  0x01,0x01,0x01,0x06,0x00,0x04,0x00,0x00,0x00,0x00,
  0x00,0x00,0x00,0x00,0x00,0x03,0x03,0x00,0x03,0x02,
  0x01,0x0C,0x05,0x05,0x05,0x05,0x05,0x05,0x05,0x05,
  0x05,0x05,0x05,0x05,0x05,0x00,0x00,0x08,0x01,0x01,
  0x01,0x01,0x01,0x06,0x00,0x00,0x00,0x00,0x00,0x00,
  0x00,0x00,0x00,0x00,0x00,0x03,0xFD,0x00,0x03,0x02,
  0x01,0x01,0x01,0x01,0x01,0x01,0x01,0x01,0x01,0x01,
  0x01,0x01,0x01,0x01,0x01,0x06,0xFD,0x08,0x01,0x01,
  0x01,0x01,0x01,0x06,0x00,0x00,0x00,0x03,0x00,0x00,
  0x00,0x00,0x00,0x00,0x00,0x03,0x03,0x00,0x00,0x02,
  0x01,0x02,0x02,0x02,0x07,0x07,0x07,0x07,0x07,0x07,
  0x07,0x07,0x07,0x07,0x07,0x00,0x00,0x08,0x01,0x01,
  0x01,0x01,0x01,0x06,0x00,0x00,0x00,0x03,0x02,0x02,
  0x02,0x02,0x05,0x05,0x05,0x05,0x03,0x00,0x05,0x02,
  0x01,0x02,0x02,0x02,0x03,0x03,0x00,0x00,0x04,0x00,
  0x00,0x00,0x00,0x03,0x04,0x03,0x03,0x08,0x01,0x01,
  0x01,0x01,0x01,0x06,0x00,0x03,0x00,0x01,0x01,0x01,
  0x01,0x01,0x01,0x01,0x01,0x01,0x06,0x08,0x01,0x02,
  0x01,0x02,0x02,0x02,0x00,0x04,0x00,0x00,0x00,0x05,
  0x05,0x05,0x05,0x05,0x05,0x05,0x05,0x09,0x01,0x01,
  0x01,0x01,0x01,0x06,0x00,0x00,0x03,0x07,0x07,0x07,
  0x07,0x07,0x0A,0x01,0x01,0x02,0x00,0x03,0x02,0x02,
  0x01,0x01,0x01,0x01,0x06,0x00,0x00,0x00,0x08,0x01,
  0x01,0x01,0x01,0x01,0x01,0x01,0x01,0x01,0x01,0x01,
  0x01,0x01,0x01,0x06,0x03,0xFD,0x00,0x00,0x00,0x00,
  0x03,0x00,0x08,0x01,0x02,0x02,0x00,0x00,0x02,0x02,
  0x01,0x01,0x01,0x01,0x06,0x00,0x00,0x00,0x08,0x01,
  0x01,0x01,0x01,0x0B,0x07,0x0A,0x01,0x01,0x01,0x01,
  0x01,0x01,0x02,0x00,0x00,0x00,0x00,0x00,0x00,0x00,
  0x00,0x00,0x08,0x01,0x02,0x02,0x00,0x00,0x02,0x02,
  0x01,0x01,0x01,0x01,0x06,0x00,0x00,0x00,0x08,0x01,
  0x0B,0x07,0x07,0x00,0x00,0x00,0x07,0x07,0x0A,0x01,
  0x01,0x01,0x02,0x00,0x05,0x00,0x00,0x05,0x05,0x05,
  0x00,0x00,0x08,0x01,0x02,0x02,0x03,0x00,0x02,0x02,
  0x01,0x02,0x02,0x02,0x00,0x00,0x00,0x00,0x03,0x07,
  0x04,0x04,0x04,0x04,0x04,0x00,0x00,0x04,0x00,0x0A,
  0x01,0x01,0x02,0x02,0x01,0x02,0x02,0x01,0x01,0x01,
  0x06,0x00,0x08,0x01,0x02,0x00,0x03,0x00,0x00,0x02,
  0x01,0x02,0x02,0x02,0x00,0x00,0x00,0x03,0x00,0x00,
  0x03,0x03,0x03,0x00,0xFE,0x03,0x03,0x03,0x03,0x00,
  0x07,0x07,0x00,0x00,0x07,0x00,0x00,0x07,0x07,0x07,
  0x00,0x00,0x08,0x01,0x02,0x00,0x00,0x0D,0x00,0x02,
  0x01,0x02,0x02,0x02,0x03,0x04,0x03,0x03,0x00,0x03,
  0x03,0x03,0x03,0x03,0x03,0x03,0x00,0x00,0x00,0x04,
  0x03,0x00,0x00,0x03,0x00,0x04,0x00,0x04,0x04,0x00,
  0x03,0x00,0x08,0x01,0x02,0x00,0x00,0x0E,0x00,0x02,
  0x01,0x02,0x02,0x02,0x05,0x05,0x05,0x05,0x05,0x05,
  0x05,0x05,0x05,0x05,0x05,0x05,0x05,0x05,0x05,0x05,
  0x05,0x00,0x05,0x05,0x00,0x00,0x00,0x05,0x05,0x05,
  0x05,0x05,0x09,0x01,0x02,0x05,0x05,0x05,0x05,0x02,
  0x01,0x01,0x01,0x01,0x01,0x01,0x01,0x01,0x01,0x01,
  0x01,0x01,0x01,0x01,0x01,0x01,0x01,0x01,0x01,0x01,
  0x01,0x02,0x01,0x01,0x02,0x02,0x01,0x01,0x01,0x01,
  0x01,0x01,0x01,0x01,0x01,0x01,0x01,0x01,0x01,0x01,
  0x01,0x01,0x01,0x01,0x01,0x01,0x01,0x01,0x01,0x01,
  0x01,0x01,0x01,0x01,0x01,0x01,0x01,0x01,0x01,0x01,
  0x01,0x01,0x01,0x01,0x01,0x01,0x01,0x01,0x01,0x01,
  0x01,0x01,0x01,0x01,0x01,0x01,0x01,0x01,0x01,0x01,
  0x01,0x01,0x01,0x01,0x01,0x01,0x01,0x01,0x01,0x01,
  0x01,0x01,0x01,0x01,0x01,0x01,0x01,0x01,0x01,0x01,
  0x01,0x01,0x01,0x01,0x01,0x01,0x01,0x01,0x01,0x01,
  0x01,0x01,0x01,0x01,0x01,0x01,0x01,0x01,0x01,0x01,
  0x01,0x01,0x01,0x01,0x01,0x01,0x01,0x01,0x01,0x01,
  0x01,0x01,0x01,0x01,0x01,0x01,0x01,0x01,0x01,0x01,
  0x01,0x01,0x01,0x01,0x01,0x01,0x01,0x01,0x01,0x01,
  0x01,0x01,0x01,0x01,0x01,0x01,0x01,0x01,0x01,0x01
};

/* End of MAP.B3.C */
